EIGTH	EY G TH
FIVE	F AY V
FOUR	F AO R
JUMP	JH AH M P
NEXT	N EH K S T
NEXT(2)	N EH K S
NINE	N AY N
ONE	W AH N
ONE(2)	HH W AH N
PREVIOUS	P R IY V IY AH S
REPEAT	R IH P IY T
REPEAT(2)	R IY P IY T
SEVEN	S EH V AH N
SIX	S IH K S
TEN	T EH N
THREE	TH R IY
TWO	T UW
1	W AH N
2	T UW
3	TH R IY
4	F OW R
